Vanessa	Snappr	Enterprise Account Executive	Hinkle
Sukhvir S.	Fastly	Account Executive	Gidha
Prateek	SwayDM	Head of Product & Co-Founder	Kumar
Michael	Seamless.AI	Chief Revenue Officer (CRO)	Hopkins
Nour	Coinbase	IT Executive Support	Ebrahim
Alexander	New York Life	Partner	Cartagena
Andre	Momentive-AI	Business Development	Tillman
Ben	Hone	Account Executive	Brandt
Justin	GoLinks	Enterprise Account Executive - GoLinks, GoSearch, GoProfiles	Doerr
Selina	SurveyMonkey	Senior Enterprise Account Executive	Woodruff
Devin	Salesforce	Account Executive	Gaines, MBA
Kriztian	Incorta	Transformation Advisor - Data and Analytics	Dela Cruz
			
Luis	madeirafriends.org	Co-Founder	Calado
David	Paradigm Strategy Inc.	Account Executive, Learning	Garc√≠a-D√≠az
Christian	Storyblocks	Sr. Sales	Bejarano
Mike	The New Business Sales Coach, LLC	Principal	Weinberg
Kate	3M	Enterprise Global Media Strategist	Frels
David	SavATree	Regional Manager	Hinault
Michael	Talkdoc	Advisor	Walker
Chris	Sourcology - Your Logical Hiring and Sourcing Solution	Director of Business Development	Parker
Walter	MeeDerby	Executive Recruiter	Shedd
Alfred	SoundThinking (formerly ShotSpotter)	Sales	Viola
Zann	Workato	Director, Demand Generation - Commercial	Yap
Matthew	iSales Solutions	Founder/Owner	Isales
Cody B.	Regal.io	Senior Account Executive - Financial Services	Meuser
Mario.	Vengreso | Type Less. Do More.	CEO and Founder | Creator of FlyMSG the Personal Writing Assistant and Text Expander	M. Martinez Jr.
Olivia	Pave	Recruiter	Bentley
Brett	Ironclad	Business Development - International	S
Zuzana	BE-ID human	CEO & Co-founder	Zamborska
Candace	THE DANA LEROYNE CAUSEY FAMILY EMPOWERMENT FOUNDATION	Human Resource Analyst	Steinebach
Kwabena	Darktrace	Senior Enterprise Account Executive	Keene
Sam	3x Capital	Venture Partner	Kamani
Eric	Culture Amp	Revenue Enablement Partner	Lindroos
Emory	Swayware	Co-Founder & CEO	Nager
Braden	Transcend	Partnerships Manager	Evans
Ben	Ringba	Solutions Consultant Manager	Carter
Sam	QuestionPro	Senior Strategic Account Manager	Warhurst
Darin	MadeByDarin	Founder	Balaban
			
Brian	Lattice	Sales Director, Commercial	Signorelli
Ryan	Suitebriar	Enterprise Account Manager	Guptill
Kevin "KD"	Bench Accounting	SVP of Sales and Partnerships	Dorsey
			
Cory	Momentive.ai	Senior Key Account Executive, EMEA	McGee
Margarita	Talenticians	Strategic Advisor	Martinez
Ryan	Quantcast	Sales Manager	Richardson
Chris	RelPro, Inc.	Senior Account Executive	Keneally
Pete	Dizolv	Founder & CMO	Aguilar
Timothy	ADT	Area Sales Executive	Webster
Shannon	Salesforce	Account Executive	Wyne
Reno	Tiny Workers	Forretningsutvikler	Yeh
Robye	I.T. Resources, Inc.	Business Development and Recruiter	Nothnagel
Cian	Trinity Perspectives	CEO	Mcloughlin
Mikolka	ServiceCore	Sr Product Manager	Morrill
Vivienne	Manafy	Consultant	Zhang
Mike	QuestionPro	Senior Account Executive	Simonis
Olivia	Child & Family Services, Inc.	Mobile Crisis Intervention Clinician	Gauvin, LCSW
Natalie	San Jose Christian School	Extended Care Staff	Orlov
Valerie	BlackLine	Senior Manager, Site Reliability Manager	Hund
Skye	Neighbor	VP of Sales	PoVey
Tyler	KCCI, LLC	Operations Manager	Cook
			
Diana	Google	App Compatibility Test Engineer	Florea
Roger	Zoom Video Communications	Healthcare Account Executive	Dorn
Nida	Box	Senior Program Manager	Siddiqui
Samantha	Autodesk	Account Executive	Auer
			
			
Adam	loanDepot	Talent Acquisition Manager	Conrad
Orly	Paxis Ceramics	Vice President Of Marketing And Business Development	Shay (Levy)
Rachel	Safecall	Team Leader - Account Management	Mackey
Arnie	Agworld	Account Executive	Sambel
Kyle	Endeavor Atlanta	Member Board of Directors	Porter
Lauren	Treasury Wine Estates	Senior Manager, Sales and Operations Planning	Craton, MBA
Alnour	Imply	Director of Sales	Zarroug
Ashima	Gong	People Business Partner	Manuel (Agrawal)
Jessy	Strategy Collective	Director Of Content Development	Smulski
Natalie	WorkRamp	Senior Implementation Manager	Buresch üè≥Ô∏èüåà
Michael	Lilitab Enterprise Tablet Kiosk Solutions	Vice President Of Business Development	McCloud
Gavin	Celtra	Sr. Manager, Enterprise Sales	Banks
Zander	Addition	Operating Partner	Lurie
Dr. Praveen	NameCoach Inc.	Founder & CEO	Shanbhag
Mark	SurveyMonkey	Senior Quality Assurance Engineer	Los
Hunter	LinkedIn	Strategy & Operations, Consumer Growth	Iwig
David	relode	Enterprise Account Executive	Heyman
Dale	Dale Isobe	Executive Recruiter	Isobe
Eliza	Friedman Strategy Group	Consultant	Friedman
Rebecca	N/A	N/A	Yang
Dylan A.	monday.com	Account Executive	Chauvin
Troy	Windfall	Enterprise Account Executive	Torgerson
MT	Thrive Global	SVP, Customer Success	Grant
Kevin	Infosys	Associate Software Engineer	Kirby
Cecilia	Plaid	New Business Sales Leader	Wilburn
Lorelei	Sage	Senior Analyst, Performance & Insights	Zabanal
Charlie	SourceScrub	VP of Sales	Buffa
Shareef	ZipDrug (An IngenioRx Company)	Business Development Account Executive	Elzein
Gisela	Kore.ai	Sales Director - Retail	Casta√±eda
Nicholas	Vanguard Properties	REALTOR¬Æ | Market Analyst	Spangler
Tyler	hireEZ (previously Hiretual)	Sr. Enterprise Solutions Engineering & Customer Success Manager	Taldone
Gabriela	Southern California Review of Law and Social Justice	Senior Content Editor	D'Souza
Joe	Regal.io	Senior Account Executive	Heredia
Harrison	Wiz	Director of Sales, Mid-Enterprise	Chase
Kevin	Samsara	Enterprise Account Executive	Chatfield
Carla	Gusto	Security Engineer	Sun
Dean	St. Michael the Archangel School	Teacher	Wheeler
Larry	Hilton	Concierge	Lawrence
Jonathan	Apricot Solar	VP of Sales Operations	M. Cohen
James	CleverTap	Account Executive	Harris
Leon	Self-employed	Software Engineer, Consultant	Perepelitsky
Lydia	Salesforce	Enterprise Account Executive (CMT | High Tech - Strat)	Grendahl
Katie	6sense	Senior Manager, Sales Development	Allan
Sebastian	J.S. Held LLC	Associate Director	Crumpacker
Dylan	ZoomInfo	Enterprise Account Manager	Muhlberg
Michelle	AT&T	Senior Content Strategist	Gray
Monica HeeJung	Samsung Semiconductor US	Director, Talent Development & Engagement	Choi, M.Ed
Claudio	Cogent Communications	Sales Engineer - Canada	Nespeca
Collin	Yahoo Sports	Video Producer	Kushner
Matthew	Slack	Account Executive	Prezzano
Radhesh	Yelp	Senior Engineering Manager - Services Monetization	Gupta
Drew	Box	Large Enterprise Account Executive	Clendenning
Ricky	Snowflake	Account Executive	Dinh
Tiffany	Direct Sales Recruiting, LLC	Administrative Operations Manager	Lewis
Zack	Guidewheel	VP of Sales	Turner
John	McKinsey & Company	Associate	Peng
Becc	Flip the Script	CEO & Founder	Holland
Wren	Asana	Enterprise Solutions Engineer	Donofrio, M.Ed
Jeff	Merchandising Metrics	Founding Partner	Sward
Erica	Envoy	Account Executive, Mid-Market Sales	Gustafson
Christian	The Offr Group	Recruiter	Lukas
Tiffany Thu	Vance Insurance	Sales Manager	Le
Ariel	Plaid	Compensation Analyst	Cessna
			
Nate	OneDigital	Senior Managing Principal	Wall
Greg	OneMonroe (Monroe Engineering)	VP Renewable Energy	Bennett
Hannah	Dynatrace	Director of Global Enablement & Operations, Sales Development	Jones
Frederick	Ocqtagon	C.E.O/Co-Founder	Mueller
Harry	High Wire Networks	Vice President, Global Strategic Accounts	Hardman
Keri	SurveyMonkey	Sales Development Manager	Dann
Hailey	Golden Sea Picnics	Small Business Owner	Romero
Samuel	Varonis	Customer Success Manager	Lee
Gilda	SurveyMonkey	Content Strategist	Raczkowski
Andrew	Nexxen	Account Executive	Leary
Tracie	Intermedia	Executive Assistant To Chief Administrative Officer & General Counsel and Chief Financial Officer	Ho
Aniyah	Stanford Center for Professional Development	Program Administrator, Global Partnerships & Professional Programs	Ross She,Her
Morgan	Compass	Agent Experience Manager	Fischer
Patrick	The Parallax	Founder	Dang
Matthew	Letsignit	Account Executive	Gubera
			
Robert	ADLINK Technology	Key Account Manager	Jones
James	Freelance	Sales Development / Enablement / Operations Consultant	Patrick
Krystna	SurveyMonkey	Enterprise Solutions Account Executive, North America	Mu√±oz
Leo	Encord	Head of Sales	Leclercq
Carly	SurveyMonkey	Senior Enterprise Account Executive	Henderson
Helen	Snowflake	Customer Marketing Specialist	Yang
Alex	Scoot Education	Teacher Assistant	Nava
Rebecca	Forrester	SMB & High Tech Account Manager III	Richards
Subhodip	Wells Fargo	Senior Software Engineer	Mukherjee
Jason	Intermountain Hydronics Specialties	Engineering Specialist	Owens
Tracy	Postman	Events & Operations	Segur
Madeline	Phrasee	Partnerships Director	Calvert
Marlon	Tesla	Tesla Advisor	Jayakoddy
Matt	Linklo.io	Founder	Hayman
Sarah	Self-employed	Stay-at-Home Parent	Ulansey
Mariana	Facebook	New Business Development	Shargorodsky
Jerri	Walmart Connect	Manager II, Learning & Development (Training & Education)	Onedera
David	PAX	Lifecycle Marketing Manager	Chan
Samuel	Bontecou Construction Inc	Project Manager	Harrison
Clayton	SurveyMonkey	Sr. Sales Enablement Program Manager	Schoenstein
Sharyn Yuloff	Yuloff Creative Marketing Solutions	Co-Founder, Business and Public Speaking Coach, HR Consultant, Career Coach	Business Coach (Marketing, HR and Back Office Sys)
Chanler	Riverside Acceleration Capital	Vice President of Talent Acquisition	Martin
			
Katrina	A Fleet Services Company	Office Manager	Maher
Jordana	enrich	Founder and CEO -- (Hiring!)	Stein
			
Tyler	Haul ATX	Owner	Alm
Emma	SurveyMonkey	HR Analyst	Raczkowski
Raelene	NVIDIA	Senior Lead Recruiter	Conkin
Art	Business By Phone Inc. - Inside sales training and cold calling training without the "cold"	Helping sales pros get through, get in, and sell more, without "rejection"	Sobczak
Rahul	MetaWhale World	Founder	Kaushik
Laura	University of California, San Francisco	Talent Acquisition Partner	Morales
Ben	King Street Capital Management	System Engineer	Bealmear
Hilmon	ClozeLoop	Co-Founder and Managing Director	Sorey
Brandon	MNTN	Sales Director	Winslow
Nicki	Nicki Sun Media	Host + Creative Director	Sun
John	MacStories	Managing Editor	Voorhees
Ryan	Amazon	Manager, Sales & Biz Dev Outdoors, home and Leisure	Wuflestad
Senior			Yellow
Bryan	Roundel	Sr. Account Executive	King
Robert	Aruba, a Hewlett Packard Enterprise company	Enterprise Account Manager	Hipolito
Conrad	WorkSpan	Senior Business Development Representative	Coutinho
Walid	Talent Einstein	Founder & Lead Developer	Aly-Hassan
Phill	Conga	Director of Business Account Management, AMER Strategic, AMER East, Public Sector	Keene
Paul	The D'Souza Group	Founder	D'Souza
Cecilia	Sheppard Mullin Richter & Hampton LLP	Recruiting Manager ‚Äì Professional Staff	Dinh
Elena	LVT ‚Äî LiveView Technologies	Sr. Corporate Recruiter	Wolpert
Unib	Applied Data Finance	Senior Consultant	Rais
Ed	ED MYLETT SHOW	Founder	Mylett
Nishant	Calsoft	Sr. Principal Development Engineer In Test	Ameta
Taylor	Jasper	Account Executive, SMB	Harrower
Chalan	Continental Public Adjusters	Public Adjuster	Rump
Amy	J. Stone Promotional Advertising	Sales Specialist	Sanchez
Lisa	xAI	AI Tutor	Martin
Sydney	Congregation Emanu-El	Rabbi	Mintz
Cliff	Taylor Cantwell Recruiting	Founder and Managing Director	Piel
Carlo	Loom	Senior Sales Recruiter	Martinez, SHRM-CP
			
Jacqueline	BigPanda	Senior Recruiter	Souvercaze
Robert	Assist You Today	Chief Executive Officer	Knop
Robyn	InGen Technologies, Inc.	Marketing Director	Oglesby
Yuliya	Intel Corporation	Strategic Account Manager (FSE), US Sales, NetStor Team	Vasudev
Ken	Schmidt's Wholesale, Inc.	Senior Sales Representative	Decker
Dawn	Accordance Search Group	Principal Recruiter	Jamison
Logan	Teamwork.com	Evangelism & Content Marketing	Lyles
Brendan	Mediafly	IT Security Engineer	Linehan
Ben	Digital i	Board Advisor	Keen
Jeremy	Pitchfire	Co-Founder & VP of Business Development	Leveille ‚Ñ¢Ô∏è
Linda	DealerShop‚Ñ¢	Administrative Assistant	Pickens
Chad	Enel X Way	Enterprise Senior Account Executive	Dickens
Darryl	Osborn	Demand Manager (SIOP)	Klein
Tori	PopCap Games	Game Studio Recruiter	Gunzenhauser
Dale	iCIMS	Solutions Consultant	McMillan
Scott	NIL Empire LLC	Founder	Eisenstadt
Navid	Bay Systems Consulting, Inc. (BSC)	Head of Talent Acquisition	Ahmadinikoo
Eugene	Roblox	Software Engineer	Panaitov
Kaelin	MarCom Group	Social Media Strategist	Okoronkwo
Natasha	Defi Trading Club	Director of Talent Acquisition	Zolotov
jasper	Qingdao Yutu Trading Co.,Ltd	Business Development Specialist	wang
Ronald	Law Office of Ronald Chun	Principal	Chun
Ryan	Apex Revenue	VP of Outbound Strategy	Reisert
üíõ Shawn	iNeverAnswer.com	Founder	Sease - The Professor of Prospecting
Jason	Posit PBC	Director of Sales	Smith
Emanuel	WorkSpan	Director of Business Development	Carpenter
Kelly	oneNav, Inc.	Manager, Human Resources and Recruiting	Camilleri
Angelo	Central Executive Search	Vice President	Giallombardo
Mimi	RTIC Outdoors	Talent Acquisition	Borbas
James	Retired	Retired Military Officer	Burgess
Jane	Amazon	Recruiting Manager	Beery-Beesley
Jingbo	Central Semiconductor Corp.	Customer Relationship Manager	Sun
Nicky	SurfaceID Industrial Design Corp.	Project Manager	Kieley
Paul	TBD Group (prev Here/Forth)	Founder	Armstrong
Renard	Leapforce, Inc	Information Technology Consultant	Pongrac
Jessica	Freelance	Business Consultant	Duval
Alexandra	RH	Talent Leader	Pezzola
Chloe Alexandra	Meow Wolf	SHOW Audio Designer	Thompson
Ben	SingularityNET	CEO	Goertzel
Amanda	The Job Chick	Executive Resume Writer & Founder	Goodall
Jonathan	Northern Natural Gas	Information Technology Staff	Carey
Asfiya	RK Management Consultants, Inc.	Recruitment Operations Team Lead - Strategic and Creative Accounts - Offshore Staffing Operations	Zaheer
Christian	Allstar Construction Innovations	Chief Executive Officer	Avalos
Robynn	Storeyline Resumes	CEO, Storeyline Resumes ‚ú® 200 million post views ‚ú® 920,000 Followers ‚ú®	Storey
			
Doug	Ariv Marketplace	Investor	Lopez
Noellee	Self-employed	The Givemas Project	Candido
Tiffany	Feeding San Diego	Agency Grants Coordinator	Fong
Felicia	Gartner	Business Development Executive - Large Enterprise	Bethea
Jace	SalesForce Search	Vice President, Sales & Recruitment	Ermidis
Samarth	Microsoft	Product Manager	Kalra
Nora	Verkada	Sales Leadership Recruiter	Madzar
Naseem	LinkedIn	Operational Reporting Analyst	Algazzali
Maya	NALCAP	US Language and Culture Auxiliary	Mogensen
Matthew	My LibertyPay	Chief Solutions Officer	Frechette
Shannon	Clean Harbors	Talent Consultant	E.
Julia	Benefit Cosmetics	Senior Inventory Analyst	Burden
Kimberly	Renowned Recruitment Group	Managing Director of Recruitment	Jin
Kevin	Webcor	Cost / Data Analyst II	Yuen
Kelsey	Central Coast Floats	Co-Owner and Manager	Elston
Alex	Sola Wood Flowers	CEO/COO	Ledoux
Dre	Workday	Digital Account Executive	Donahue
Jim	GET PLACED!	National Sales Recruiter	Serrano
Selena	DocuSign	Principal Recruiter	Stirlen
Peeya	Google	Technical Program Manager	Iwagoshi
			
			
Stacey	Orange Coast College	Pre-nursing Student	Kim
Ian	ZipRecruiter	Co-Founder & CEO	Siegel
Paul James	Snowflake	Practice Director, Enterprise Northwest	Pachence
Alan	ezCater	BDR Manager, Acquisition	Bautista
Ashley	Westways Staffing Services, Inc	Corporate Recruiter	Wheeler
Tomer	iCon Group	Planning Manager	Shami
Arthur	ELECTRUN	Chief Marketing Officer	Thomas
Alex	Frost Bites Shaved Ice	Co-Owner	Russell
Cezanne	Nova Module	Sales Development Representative	Calumaya - Lim
Alyssa	Gate Gourmet	Customer Account Manager	Simon
Winston	Consulting	Founder	T.
Carl	Unlimit	SVP Sales, North America	Miller
Andrew	Turning Prose Into Profits LLC	Resume Writer and Content Editor	Friedman
Harry	Sedona Golf Resort, L.C.	Groundskeeper	Ahn
Dan	Calyptia	Community Development & Social Media Manager	Saso ü§†
Rick	NASP - National Association of Sales Professionals	Chief Operating Officer	Middlemass, CPSP, CPSL
Meemansa	Sagar Group (SIRT Bhopal) | Sagar Group of Institutions	Communication & Soft Skills Trainer	Khare
Omar	Pure Storage	Senior Technical Sourcer	Aziz, MBA
Hailey	Samsara	Senior Executive Assistant	Warren
Kim	Matthew Young, DDS	Registered Dental Hygienist	Adams, RDH
Guillaume	Nestl√© Nespresso SA	Chief Executive Officer	Le Cunff
Michael	Identity Praxis, Inc.	Founder, CEO	Becker
David	Playbook Media	Strategy Consultant	White
Hailey	Vendition	VP, Talent Acquisition	Burkett
Jacob	Tesla	Inspection Coordinator II	Fine
Mei	LeadIQ	Co-founder & CEO	Siauw
Elsie	Maui Health	Interim Leader of Interventional Cardiology, Neurology and Vascular Units	Crowninshield
Erik	Tailormade Works	Founder	Gavrilov
Julen	Gravity Wave S.L	CO-CEO Gravity Wave	Rodriguez
Barbara	Career Pathways Consulting	CEO & Founder	Mason
Lisa	Rakuten Americas	Senior Buyer - Commodity Specialist/Manager	McBride
Jessica	Chevron	Merchandise Coordinator	Allen
Monti	BAE Sales Inc.	Distribution Manager/Account Manager	Cadwallader
Babette	One Millimeter Mindset‚Ñ¢ Speaking Programs	Keynote Speaker, Coach & Consultant: Virtual & In-Person Programs	Ten Haken
Sony	Kineviz	Chief Operating Officer	Green
Rachael	Dialpad	Senior Manager, Global Talent Acquisition	Vacca
David	David Greenberg Coaching & Consulting LLC	Coach, Consultant, Educator & Youtuber	Greenberg
Vincent Hua	Lucid Motors	HQ inside sales advisor	Wu
Gal	Deci AI	Global Sales Development Director	Ben-Avinoam
Aral	StoneX Group Inc.	Product Designer	Tasher, UXC
Ryan	Indeed.com	Senior Account Executive	Fanning
Spencer	eXp Realty	Realtor	Hsu, MBA, Realtor
Anna	AnnaWickham.com	Life Coach & Podcast Host	Sharma
Ben (Akiva)	Milwaukee Property Management LLC	Investor Relations Executive	Bergman
Delaney	innRoad	Talent Acquisition Team Lead	Nikolai
Alexandra	Shift Digital	Program Manager	Murawski
Nick	asktheheadhunter.com	The Headhunter	Corcodilos
Shaikh	IMS Group	Team Leader - UK Recruitment	Mohammed Azim
Kat	NASA Jet Propulsion Laboratory	Subcontracts Manager	Canlas
Jessi	Sealed	Vice President, Sales	Pak Barrnett
Ashley A.	Emblaze	Vice President, Community & Sales	Gagliano
Jack	ArtChocolat	Founder and Head Chocolatier at ArtChocolat	Ralph
Cezar	Wittmann Battenfeld	Software Engineer	Popescu
Jennifer	Beyond Pearls	Artistic Director	Dinoia
Diana	H&W Internationals Electronics ÔºàHKÔºâCo,.LTD	Project Manager	Huang ( Manufacturing and Hardware)
Dana	Malta Consulting	Owner	Baldwin
Cody	Zight (formerly CloudApp)	SVP of Revenue	Gilland
RJ	Blip	Chief Operating Officer	Schultz
Anthony	Soapy Joe's, Inc.	Office Coordinator	Siegrist
Sulaiman	-Independent Consultant-	Senior Information Technology Consultant	Shansab, MA
Thena	@loveandliberation.co	Dating Coach & Matchmaker	DiNapoli
Darcy	Roth Staffing	National Account Manager	Bryan
Steffanie	Anduril Industries	Talent Acquisition	Davis
Manny	ManpowerGroup	Market Manager	Ramos
Alex	Dragonfruit AI	Sales Director	Kochanik
Lauren	Mindshare	Global Director, Talent Acquisition	Baraby
Michael	9to5mac.com	Editor	Potuck
			
Alex	Snowflake	Manager, University Recruiting Programs	Haverty
Jagruti	AppOmni	Talent Acquisition	Desai Shah
Dani	Veriff	ABM and Field Marketing Manager	Stancheva
Adam	Spiro.ai	Chief Executive Officer	Honig
Emma	Women Impact Tech	Vice President - Corporate Partnerships	Miller
Tracey	Kandor Solutions, Inc.	Head of Talent Acquisition	Sullivan
Freddie	Bitcoin Inc.	Crypto Analyst | Bitcoin Miner	Hidalgo
Zoe	The Bishoff Financial Group, Inc.	Associate Financial Advisor	Hedin, CFP¬Æ
David	Perceptyx	Enterprise Account Executive	Schmidt
Dan	SuperSmart.ai	Founder	Clark
Kyndra	Google	Senior Brand Accessibility Program Manager	LoCoco
Peter	Braindance Academy	Group CEO	Dunn
Jamal	Sequoia Capital	Lead Sales & GTM Talent Scout	Elmidge
Kyle	Cisco	SaaS Security Specialist ‚Äì MN, ND & SD, IA	Miller
Kim K.	Future Focus Financial & Insurance Services, LLC	President	Colby, R.I.C.P¬Æ
Raif	World Supply International	Associate	Rahal
Janey	South Bay Regional Public Safety Training	Scenario Role-Player for Law-Enforcement	Hodges
Melissa	Telgorithm	Advisor	Lui
Malia	Handshake	Employer Account Executive	Malin
Emmanuel	SavynCard	Marketing/Sales Supervisor	Ohale
Annie	Spring Health	Global Recruiter	Aphay
Nicholas	Leap Inc	Senior Recruiter	Lee
Angelo	Creative Directions Recruiting (CDR)	Sr Consultant (TA)	Caruana
Nischel	Various Marketing Companies	Managing Partner	Soni
Danny	preHIRED	Certified in Science-Based Sales¬Æ - Sales Analyst	Chu
James	PeterHunt	Executive Recruiter	Hsu
Andrea	Rimini Street	Senior Recruiting Consultant	Jablon, MD
Monica	Herself Health	Talent Partner	San Juan
Sam	Agoge	Founder	Nelson
Kevin	Hopp Consulting Group	Founder	Hopp
Richard	Nirmata	Director Of Recruiting	Phillips
Matt	Voltus, Inc.	Director of Inside Sales	Tschirgi
Carlos	Larry Flynt's Hustler Club San Francisco	Resident Disc Jockey	Fishburn
Evangelia	Danbury Hospital	Emergency Registered Nurse	Markaki, BSN, RN
Kevin James	AUTODOC	Interim Head of Talent Acquisition	Seay
Shahin	Dprogram.net	Owner	Pahlavan - Dprogram.net
Sneha	University of Chicago	Assistant Director | MPCS Career Services	Alagappan
Brittany	Workday	Engagement Manager	Landis
Alex	Clari	Commercial Sales Director	Jagiello
Tyler	Abnormal Security	Sr. Recruiter	Chimarusti
Nada	Samsung Semiconductor	Sr Technical Recruiter	Faqih, MBA
Joseph	Blue Orange Games	National Sales Manager	Heber-Suffrin
Kathleen	Comcast Cable	Sales Recruiter/Sourcer	Pashote
Janet	Flashbay	President North America	Abke
Liz	Consulting	Human Resources, Onboarding, and Recruiting Consultant	Angeloni
Juron	Lifeworks Technology Group	Customer Service Support Manager	Gause
Mirela	The Breakthrough Hiring Show	Podcast Producer	Marga
Celi	Databricks	Leader, Talent Acquisition Recruiting (GSC, Digital Native Sales)	Raffin
Daniel	AppLovin	Producer	Sotelo
Nereida	PABCO Building Products, LLC.	Subsidiary Human Resources Manager	Ya√±ez Lenoir, PHRca
Kara	GM Financial	Sr. Talent Advisor	Comeau
Anthony	Dallas Mavericks	Human Resources Business Partner	Randall
Danny	CyberCoders	Executive Recruiter	Alexander
Wes (Christopher)	Breakthru Beverage Group	Talent Acquisition Specialist	Shoup, CSM
Bernadet	ReversingLabs	Director Talent Acquisition (US & EMEA)	Kalta
Claire	Beyond Finance	Talent Acquisition Specialist	Colburn
Johanna F	Bloomberg	Talent Acquisition, Sourcer - News, Media, & Research	Kupe, M.S.
Roya	HelloFresh	Sales Recruiter, Talent Acquisition	Rubey
Kerrie	Freshworks	Lead Recruiter	Joseffer
Julie	Julie M. Healy Associates	Go-To-Market Sales Sourcer/Recruiter	Raizes, QTC certified
Angelica	ServiceNow	Senior Recruiter - Solution Consulting	Villarreal
Rachel	Red Ventures	Director, HRBP	(Nogare) Robinson
Michelle	MBVH Consulting	Founder	Huynh
Pam	Personal	Semi Retired	Shekell
Bobby	Climate Works	Recruiter	Burse
Jade	Brown & Brown Insurance	Talent Acquisitions	Edwards
Jason	Western Digital	Senior Director Talent Acquisition	Smith
Laura	Gong	[Interim] Chief People Officer	Wilson
Monica	Siam Herbal Tech Company Limited	Director of International Development and Sales	Garcia
Paola D.	Ceros	Senior Recruiter, Revenue	Pensato-Failler, SHRM-CP
Lauren	Pursuit Sales Solutions	Director Of Recruiting	Raincsuk
Shaina	CARET	Senior Corporate Recruiter	Thomason
Angela	ALH Search	Founder | Senior Sales Recruiter | Consultant	Howarth
Justin	Amazon	Global Sales Account Executive	Lozano
Farah	Google via Adecco	Recruiter, Early Career SWE	Patel
Doug	Cedar Hills Hospital	Therapist	Lytz
Laura	Thryv	National Partner Sales Manager	Gibbs
Adrianne	Self Employed: from 2017 to current date:	Senior Sales Recruiter	Wellman
Mary	Palo Alto Networks	Senior Manager, GTM Recruiting	Moldt
Sheila	Limit Break	Senior Talent Operations Manager	Winslow
Aaron	Scopely	Sr. Manager, Global Talent Acquisition	LeMire
Elizabeth	King & Bishop	Full Cycle Talent Acquisition Recruiter	Rojas
Savanah	Pinterest	University Recruiter & Program Manager	Mendoza
Alexis	Thrive	Senior Recruiter l GTM l G&A l Product l Engineering	Davis
Lindsey	Sprinklr	Recruiting Lead	Pierini Hall
Scott	BMC Software	Senior Sales and Technical Recruiter	Lawrence
Sam	Grocery Outlet	Senior Internal Communications Specialist	Wilson
Mallory	Congregations for Kids	Volunteer	Linville
Jessica	Figma	Program Manager, Recruiting Operations	Bent
Jamie	Meta	Technical Recruiter	Mesquite
Sonja	Optimal Sales Search	Software Sales Recruiter Nationwide Sales Executive Search	Hastings
Christine	Cyware	Senior Talent Acquisition Specialist	Covert
Ricky	Wiz	Lead Talent Partner	Urrutia
Fay (Atefeh)	Sales Enablement Society	Member	Nazarian
Jacquelyn	Cyberhaven	People Operations Manager	Zuniga
Anthony	Respawn Entertainment	Senior Recruiter	Stephenson üéÆ
Alison	Birdeye	Talent Acquisition Specialist	Redmond
Kristin	Cummins Inc.	Executive Sourcer	Vacca
Sarah	Outset Medical, Inc.	Recruiting Manager	Gilligan
Jason	Maple Street Advisors	Go-to-Market Senior Advisor	Jordan
Christian	Snowflake	Enterprise Account Executive	Ronda
Phinni	Apple	Technical Recruiter	Benjaminson
Jennifer	Plaid	Revenue Recruiting Manager	Michaud, PHR
Kristen	Meet	Division Manager, Medical Device & Diagnostics	Tiftickjian
Charisma	Better Capital Fund	Investor Relations	Machado
Alejandro	Airbnb	Recruiting Manager, Global Business	Perez
Matt	Workday	Program Manager, Community Engagement	Lasker
TRACY	Korn Ferry	Senior Partner, Professional Search, Sales Marketing & Digital	Nichter Baxter
Kevin	Evisort	Senior Sales Recruiter	Moriarty
Victoria	TikTok	Technical Recruiting	Williams
Lianne	Gong	Sr. Manager, G&A/Business Recruiting	Gong
Ryan	Ridgeline	Staff Sales Recruiter	Alves
Lina	Google	Senior Recruiter	(Vera) Rodriguez
David	Tenbound	Founder & CEO	Dulany
Todd	SambaNova Systems	Principal Recruiter	Dehlin
Susan	TCA, Inc	CEO	Park, MBA
Raj	California Innovation Development Incubator	Account Manager	Gupta
Cristina	BackerKit	Senior Customer Success Manager	Mihalik
Scott	Organizational Turnaround/Growth Consulting	Executive Consultant	Salyer
			
Cory	CoachCRM	Co-Founder	Bray
Tyler	ZoomInfo	Enterprise Account Executive	Loughlin
Meytal	iStore Israel	Logistics Manager	Alul
Tiffany	EROAD	Operations - Accounts Salesforce Analyst	Tallar
Jim	Kwik Brain	Founder	Kwik
Justin	Hard Skill Exchange	Co-Founder & CRO	Michael ü¶∏‚ôÇÔ∏è
Michael	Okta	Regional Sales Manager, Enterprise - SA/WA	Phillips
Macy	Concero	Business Operations Analyst	Ostrand
Thomas	Raise the Bar	Operating Manager	Sheppard
Mike	Adobe	Sr. Product Marketing Manager, Enterprise GTM, Creative Cloud Video	Min
Shela	Edge	Senior Recruiting Manager	Owens
Garrett	DIG Labs	Head of Partnerships	Grohman
Clint	Klikk Limited	Corporate Manager & Purchasing Executive	Cacciattolo
Tiago	IP Fabric	Sales Director	Castro
Jennifer	Adobe	Sr. Product Manager	Yim
Varinder	Levi Strauss & Co.	Automation Architect	Singh
Artem	testRigor	Co-founder and CEO	Golubev
Kevin	Treeline, Inc.	Senior Executive Recruiter	Burke
Dinesh	Iris	Technical Advisor - Integration	Sharma
Diane	ACD Heath US	National Sales Director	Walsh
Shashank	ServiceNow	Senior Director, GTM Strategy and Product Management	Saggar
Alyssa	Cypress HCM	Recruiting Manager	Ferrari
Hassan	Juvenile Court	Assistant Computer Technician	Zaeem
Bill	Sales Hacker	Community Member	Smith, CSM¬Æ, CSSGB‚Ñ¢
Arpan	OneSpan	Enterprise Director	Jain
Lan	Run:ai	Sr. Client Executive	Hoang
Max	Jamf	Enterprise Account Executive - Jamf Executive Threat Protection	Simpson
Cheri	Ask a Chief of Staff	Community Member	Holmes
Melissa	The Institute of Certified Bookkeepers	Non Executive Director - ICB Board	Foote
Luke	Michael Page	Executive Search Consultant-Automotive Industry	MIAO
Ramon	Capsule	Logistics Project Manager at Capsule	Paradela, PMP
David	Apple	Siri QA Engineer	Swain-Salomon
Glenn "GG" Dale	Crew One	Entertainment Ground Rigger	Gordon
Estefanie	Taco Bell	Equitability Inclusion and Belonging Specialist	Costa
Margaret	Compass	Licensed Realtor	Olen
Eric	HubSpot	Product Lead, Academy Product Group	Peters
Royal	Hapn	Founding Account Executive	Bateman
Mahendran	J&C Associates Ltd	Recruiting Lead -UK Region	Dhas
Jimmy	Shenzhen Meixin Electronic Co., Ltd.	Sales Manager	Zou
Michelle	Shenzhen Jinhongyuan Electronic Technology Co., Ltd.	Sales Manager	mi
Jackie	LocalBy	Founder	Bernhelm
